50
20
20
0 1 7 4 0 12 12 2 2 2 2 2 2 12 12 0 4 7 1 0 
1 9 7 14 2 15 5 -14 13 12 12 13 -14 5 15 2 14 7 9 1 
-4 3 -6 10 2 5 4 12 0 13 13 0 12 4 5 2 10 -6 3 -4 
1 4 3 10 13 11 4 12 12 13 13 12 12 4 11 13 10 3 4 1 
0 12 4 10 8 2 0 7 -2 13 13 -2 7 0 2 8 10 4 12 0 
15 11 6 15 6 2 2 14 10 13 13 10 14 2 2 6 15 6 11 15 
7 4 7 0 10 15 -11 3 3 -2 -2 3 3 -11 15 10 0 7 4 7 
11 1 1 3 14 12 5 11 13 7 7 13 11 5 12 14 3 1 1 11 
2 9 9 11 3 15 5 3 5 3 3 5 3 5 15 3 11 9 9 2 
7 0 9 0 11 5 4 2 1 12 12 1 2 4 5 11 0 9 0 7 
14 -13 10 15 6 7 15 0 12 10 10 12 0 15 7 6 15 10 -13 14 
9 1 6 3 -10 -13 12 5 3 13 13 3 5 12 -13 -10 3 6 1 9 
12 6 12 4 6 1 15 4 1 -3 -3 1 4 15 1 6 4 12 6 12 
13 6 4 14 -8 6 14 9 7 4 4 7 9 14 6 -8 14 4 6 13 
15 13 5 5 13 10 2 15 0 0 0 0 15 2 10 13 5 5 13 15 
0 -1 5 7 8 9 15 7 3 12 12 3 7 15 9 8 7 5 -1 0 
-1 0 1 1 6 4 5 6 9 8 8 9 6 5 4 6 1 1 0 -1 
6 10 13 6 0 1 7 14 1 4 4 1 14 7 1 0 6 13 10 6 
14 0 13 14 2 4 11 15 2 3 3 2 15 11 4 2 14 13 0 14 
5 13 5 11 12 14 -2 14 1 15 15 1 14 -2 14 12 11 5 13 5 
2
12 18
12 12
7 18
7 12
